52,21
1111111111111111111111111111                       1
1          1             111 p h p h               1
1          1      M      111  h p h p              1
1          1   1 a 1     111 p h p h               1
1    a        111111     1111111111111   1 11      1
1    1  M                 R         11             1
1   11     33                    M g111       111111
111111111111111111111   1111111111111c         c1   
1                   1    11111111111211 1    1111   
1      3            11   G          1hp     111     
1     333   3       1               2ph      c1     
222222222222222222222   111111   1111111   1111     
2                       31                11111     
2                      331     P            111     
2 r   M              33331    111       111 111     
22222222222222222222222222                  111     
                         1         1  1     111     
                         1                  111     
                         1                  111     
                         1ssssssssssssssssss111     
                         1111111111111111111111     